absence	excellent	pneumonia
accidentally	excitement	possess
accommodate	experience	practically
achieve	familiar	preferred
acquaintance	fascinate	privilege
against	favorite	probably
a lot	February	raspberry
already	finally	realize
argument	foreign	receive
attendance	friend	recommend
because	government	remember
beginning	grammar	restaurant
believe	guarantee	rhythm
business	height	ridiculous
calendar	immediately	schedule
cemetery	independent	scissors
chief	instead	separate
committee	interrupt	similar
conscience	judgment	sincerely
convenience	leisure	straight
courageous	library	strengthen
criticize	lightning	studying
decision	lonely	summarize
definitely	lying	surprise
desperately	millionaire	thorough
dictionary	mischievous	tomorrow
different	necessary	truly
disease	niece	until
doesn't	noticeable	vacuum
embarrass	occasion	vegetable
enough	occurred	Wednesday
environment	opposite	weight
especially	particular	weird
exaggerate	physical	yacht