modesta	modest (not boastful)
gratuli	to congratulate
vergo	wand, rod, switch, twig
ombrelo	umbrella
sitelo	pail, bucket
malvarmumo	cold (illness)
fabriko	fabric, factory, manufacture
ezoko	pike (fish)
drapo	cloth, woolen cloth, sheet
araneo	spider
heredi	to inherit
funto	pound
pulvo	gunpowder
raporti	to report, to give a report
kruta	steep
mamo	udder, breast, teat
petrolo	petroleum, kerosene
kaso	moneybox, treasury
teorio	theory
gesti	to gesture
poezio	poetry
frakasi	to shatter, break to pieces
pasio	passion
kondamni	to condemn
pleto	tray
maĉi	to chew, masticate
febro	fever
beni	to bless
kverko	oak
nervo	nerve
fiziko	physics
distribui	to allocate, apportion, distribute
temperaturo	temperature
tendaro	camp (n)
salono	living room, lounge
akurata	accurate, on time, prompt, punctual, exact, precise,
kino	the cinema (films)
palaco	palace
malbeni	to curse
brava	brave, gallant, good, honest, stalwart, staunch, valiant, valorous, worthy
robo	dress, gown, robe
mekaniko	mechanics
rekordo	record (unexcelled performance)
malprofito	loss (financial)
abomeno	abhorrence, abomination, horror, disgust, loathing
kubuto	elbow
admiri	to admire
profesio	profession, occupation, calling
aŭtoritato	authority
melki	to milk
parko	park
deklari	to declare, state, proclaim
problemo	problem
tajli	to cut, polish (as in diamond, cloth)
anaso	duck
nivelo	level
preteksto	pretext, excuse
arko	arc, bow, arch, buttress
friti	to fry
skui	to shake
kastelo	castle
mino	mine (of coal, silver, etc)
tono	tone (note)
juro	jurisprudence; law
sekretario	secretary
vualo	veil
financo	finance
sporto	sport
barelo	barrel, cask
stampi	to mark officially, to stamp
naŭzi	to nauseate
ŝargi	to charge, load
dramo	drama, thriller
mandato	money order
adopti	to adopt
stango	pole
urso	bear
proceso	legal process, lawsuit
bebo	baby
velki	to wilt, to wither
sveni	to faint, to swoon
striki	to strike (of workers)
krizo	emergency, crisis, depression
importi	to import
gladi	to iron (clothes)
identa	identical
marĉo	swamp, marsh
arda	ablaze, afire, aflame, aglow, ardent
krono	crown
ripo	rib
regali	to regale, to treat (to food or drink), to entertain
sojlo	threshold
telegramo	telegram
dependi	to depend
eleganta	elegant
pupo	doll
modera	moderate
pulmo	lung
kruela	cruel
studento	student (college, etc)
oscedi	to gape, yawn
tempesto	storm, tempest
hospitalo	hospital
moderna	modern
kateno	fetter, chain
suspekti	to suspect
vidvo	widower
benzino	petrol, gasoline
munti	to assemble, mount, set
trajno	train
faŭko	jaws, maw
muso	mouse
profito	profit
esenco	essence, gist, substance
kritiki	to criticize
vakcino	vaccine
mediti	to meditate
tipo	type
tribunalo	tribunal, court
pato	pan, frying pan
trajto	feature
emocio	emotion
escepti	to except, exclude
orto	right angle
moskito	mosquito
kaprica	fitful, capricious
disko	disk
funebro	mourning
triangulo	triangle
aviadilo	airplane, aircraft
entrepreni	to undertake (take it upon oneself to do)
trezoro	treasure
reciproka	reciprocal, mutual
disputi	to argue, dispute, bicker, contest, wrangle, contend
originalo	original (not a copy)
indiferenta	indifferent
albumo	album
frago	strawberry
alkoholo	alcohol, spirit
kripla	crippled
trunko	trunk (of tree or body)
posteno	station, post, place of duty
prokrasti	to procrastinate, to put off, to postpone, to delay
rezigni	to forgo, renounce; give up
duŝo	douche, shower
asocio	association (organization)
surfaco	surface (of something)
vito	vine, grapevine
kompleta	complete, entire, fully
motoro	motor, engine
recepto	recipe; prescription
elturniĝi	to wangle, contrive, maneuver
fanfaroni	to bluster, boast, brag, swagger, boast
piro	pear
veneno	poison
pilo	pile, cell of battery
krepusko	twilight
kajo	quay; platform
varo	commodity; (item of) wares, merchandise
riski	to risk
detalo	detail
cemento	cement
kupro	copper (metal)
cirkonstanco	circumstance
adicii	to add (up), count in
observi	to observe, to take note of
kukolo	cuckoo
procedi	to proceed
trotuaro	sidewalk, pavement
literaturo	literature
komisiono	commission
imperio	empire
perfekta	perfect
normala	normal
sopiri	to yearn, to long for
stumpo	stump (of tree, etc)
senescepte	without exception
grajno	pip, granule, grain
operacii	to operate (surgery)
konkludi	to induce, to infer, to abstract, to gather, to conclude
eksplodi	to explode
ganto	glove
masto	mast
balanci	to rock, swing, sway, nod
rifuĝi	to take refuge, shelter
apartamento	apartment
senso	sense (sight, hearing, etc.)
atesti	to attest, to certify
genio	genius
minus	minus
deserto	dessert
ŝelo	shell, bark, peel
gloro	glory
humida	humid, damp, moist
strukturo	structure
kalkano	heel (of the foot)
sagaca	astute, shrewd, resourceful
brovo	brow, eyebrow
ĵaluza	jealous
brakumi	to embrace, hug
tordi	to twist
civilizi	to civilize
bubo	brat, boy (often pejorative)
ŝraŭbo	screw
vulpo	fox
modelo	model
metodo	method, way
knedi	to knead
konferenco	conference
ebria	drunk, intoxicated, tipsy, inebriated
panjo	mum, mummy, mom, mama
pelto	coat or wrap of fur
lifto	lift, elevator
serena	serene, calm
velo	sail
ekstrema	extreme
heroo	hero
komika	comical, funny
almozo	alms, charity, handout, charitable relief
strio	streak, stripe, band
migri	to migrate, to roam, to wander, to wander about
kolumo	collar (clothing)
penti	to repent
stilo	style
verbo	verb
amplekso	amplitude, bulk, dimension, extent, size, scope, magnitude, range
ŝmiri	to anoint, to smear
hufo	hoof
dungi	to employ, engage, hire
rekompenco	reward, compensation
administri	to administer, manage
koto	mud
konfuzi	to confuse, confound
ju pli	the more....
rabi	to pillage, to plunder
envii	to envy
afiŝo	notice, placard, poster, bill, sign, article
patrono	patron
garantii	to guarantee, to warrant
instali	to install
bremso	brake
fleksi	to bend
ritmo	rhythm
sovaĝa	wild, savage
inklina	inclined (to), disposed
degeli	to melt, thaw
signalo	signal, sign
apoteko	drugstore, pharmacy, chemist
fundamento	foundation, base
pejzaĝo	landscape
ĉerpi	to bail, draw (water), excerpt, extract, spoon
kinejo	cinema
kolono	column, pillar
ronki	to snore, snort
muskolo	muscle
tajloro	tailor
ŝtalo	steel
poemo	poem
kamiono	lorry, truck
lupo	wolf
triki	to knit
kabineto	(room) study, office; (politics) cabinet
sklavo	slave
bazo	base, foundation
citi	to cite, quote, mention
svingi	to swing, to brandish
konfidi	to trust, have confidence in
biciklo	bicycle
intelekto	intellect, mind
hajlo	hail (frozen rain)
ĉerizo	cherry
veŝto	vest, waistcoat
bombono	bonbon, piece of candy, sweet
segilo	saw (tool)
virto	virtue
varii	to vary (intr)
ĉeno	chain, sequence
simpatio	liking, fellow-feeling
nobla	noble (character)
mastrumi	to manage, to keep house
ŝuti	to pour out, tip out
konvinki	to convince
korko	cork (substance)
kvartalo	quarter (of a city)
eminenta	distinguished, eminent, prominent
gluti	to swallow
enigmo	enigma, puzzle, riddle
kuglo	bullet
plenumi	to fulfil
eksperimento	experiment
instigi	to spur on, to encourage, to impel, to instigate, to urge
kreto	chalk
maldungi	to sack (employee)
putri	to rot, putrify
sistemo	system
bori	to bore, drill
plekti	to weave, to plait, to braid
verto	top of the head
ŝovi	to shove, to push
tedi	to be tedious
dekoracio	décor, decoration, theater set
bazaro	bazaar, fair, market, department store, mall
ilustri	to illustrate
listo	list
rampi	to crawl
akceli	to accelerate, advance, further, hasten, promote, speed up
kandelo	candle
betulo	birch (tree)
hoko	hook
orfo	orphan
abelo	bee
kanzono	chanson, song, ballad
komandi	to command (military and naval)
fendo	cleft, crack, crevice, rift, slit
pretendi	to make pretension to, to lay claim to
turmenti	torment
tegi	to cover, to put a covering upon
cerbo	brain
treni	to drag
kalendaro	calendar
krusto	crust
saŭco	sauce, gravy, dressing
avida	avid, eager, greedy
ĉeko	check
rosti	to roast
nenies	nobody's
animalo	animal (as opposed to vegetable or mineral)
frizi	to dress hair, to curl, friz, frizz (hair)
perfidi	to betray
provizo	provision, supply
plus	plus
garaĝo	garage (car); dock (boat); (train) siding
reklami	to advertise
trakti	to deal with, handle, treat
bankalsono	bathing suit, swimming trunks, swimsuit
fulgo	soot
afranki	to prepay, put on stamps, frank
krano	faucet, tap
idealo	ideal
insulti	to insult
golfo	gulf, bay; golf
funkcio	function (mathematics: one-to-one relation)
malneto	draft (of document)
trempi	to drench, to dip, to soak
aŭto	automobile, car
cedi	to cede, give in, yield, comply, concede, grant, accommodate
fonografo	record-player
oferi	to sacrifice, to offer
paŝti	to feed (cause to feed), to pasture
fondi	to found, to establish
rango	rank, grade, dignity
rezisti	to resist, to withstand
rato	rat
revi	to indulge in reverie, to daydream
komo	comma (punctuation)
konfirmi	to confirm, corroborate
kliento	client, customer
kilometro	kilometer
broŝuro	brochure, leaflet, pamphlet, paperback
diablo	devil
ĵurnalo	newspaper
kurteno	curtain
butiko	store, shop
advokato	advocate, barrister, counsel, intercessor, lawyer, solicitor, attorney
remi	to row
insisti	to insist
apetito	appetite
nodo	knot, node
komplezi	to oblige, do a favor for (tr)
distingi	to differentiate, discern, discriminate, distinguish, mark
kopii	to copy
avenuo	avenue
kopio	(a) copy
juvelo	jewel
pulvoro	powder
dediĉi	to consecrate, dedicate, devote, set aside, vow
pioĉo	pick-axe
konscienco	conscience
boato	boat, vessel, ship
tereno	terrain, grounds
neto	final copy
konkuri	to vie, compete
ĵuri	to take oath, to swear
konjekti	to surmise, conjecture, make guesses
inteligenta	intelligent
foiro	fair, market
prozo	prose
neniom	nothing at all, nothing
karesi	to caress
parfumo	perfume
boji	to bark (of dogs)
respubliko	republic
naiva	naive
bluzo	blouse
sorĉi	to bewitch
kemio	chemistry
segi	to saw
nadlo	needle
admoni	to admonish, advise, censure, exhort, scold, reprimand, tell off
kalsono	underpants, trunks
frambo	raspberry
kruĉo	pitcher, jug
anĝelo	angel
barakti	to struggle (against), writhe, wrestle, move convulsively, convulse, flounder
frizisto	(ladies) hairdresser
deficito	deficiency, deficit
sekso	sex
elefanto	elephant
koncerto	concert
instrumento	instrument
asekuri	to assure, insure, underwrite
influi	to have influence on
adjektivo	adjective
revuo	journal, review, magazine
mistero	mystery
ravi	to enchant
traktoro	tractor
ribeli	to rebel, to revolt
medikamento	medicine, medicament
delegi	to delegate
pinĉi	to pinch
ŝoforo	driver, chauffeur
destini	to assign, consign, designate, destine, dispose, earmark, ordain
flari	to smell
kontroli	to control, to inspect, to examine and check
teatro	a theater
kapitalo	capital (money)
biblioteko	library
leki	to lick
milimetro	millimeter
ebriulo	drunk person, drunk(ard)
mekanismo	mechanism
mamulo	mammal
plumbo	lead (metal)
krado	grating, grate, lattice
peniko	paintbrush
impreso	impression
flirti	to flutter; stream; flit; flirt
imposto	tax, impost
fosto	pole, stanchion, stake, post
kitelo	smock, overalls
oficiala	official
tendo	tent
ĉagreni	to aggravate, annoy, distress, vex, worry, grieve
sufoki	to suffocate
penetri	to penetrate
kontrakti	to contract, agree
komisii	to entrust with, to put in charge of, to give the agency for
paĉjo	dad, daddy, pop, popa
kordo	cord, string
ekvilibro	equilibrium
pruvi	to prove, to give proof of
sobra	abstemious, staid, sober, temperate
felo	fur, hide, skin, pelt
farbo	dye, paint
ekonomio	economy
paŭzi	to take a break, to pause, to take a rest
he	hey!
konfiti	to preserve with sugar
silko	silk
bulvardo	boulevard
inĝeniero	engineer
Pasko	Easter
pozicio	position
probabla	probable
pumpi	to pump
simio	monkey
fervora	zealous, fervent
ŝraŭbilo	screwdriver
baki	to bake, cook in an oven
aboni	to have a subscription, subscribe to
festeni	to feast, have a party, attend a party
olivo	olive
ŝtofo	cloth, material
sprita	witty
miliardo	billion, 10^9
mapo	map
rezervi	to reserve
lameno	lamina, plate, layer
